7
7
2
0
0
6
6
0 1 2 3 4 2 1
1 2 3 4 5 4 2
3 4 5 6 6 5 4
2 4 5 7 5 3 2
1 2 4 5 3 2 1
0 1 2 3 1 1 1
0 0 1 2 1 1 1